NO ./path_to_the_north_texture
SO ./path_to_the_south_texture
WE ./path_to_the_west_texture
EA ./path_to_the_east_texture
F 220,100,0
C 225,30,0
             

      
        11111111111111111111111111
        10000000000000000000000001
        1011000001110000000000001
        1001000000000000000000001
        1111111110110000011100011
1111111111000001110111111111111
11110111111111011100000010001
11110111111111011101010010001
11000000110101011100000010001
10000000000000001100000010001
10000000000000001101010010001111
111101111101111111111100111110111
1111111 1110101       101111010001
1111111 1111111        11111111111111
