NO ./textures/cropped.xpm
SO ./textures/cropped.xpm
WE ./textures/cropped.xpm
EA ./textures/cropped.xpm
F 255,255,255
C 0,0,0

        1111111111111111111111111
        1000000000110000000000001
        101100000111000000100001
        10010000W0000000010000001
111111111011000001110000000000001
100000000011000001110111111111111
11110111111111011100000010001
111100011111111011101010010001
11111110110101011100000010001
10000000000000001100000000001
111111111111111111101010010001
1100000111010101111101111000111
11110111 1110101 101111010001
11111111 1111111 111111111111

