NO ./textures/1.png
SO ./textures/1.png
WE ./textures/2.png
EA ./textures/2.png
F 200  ,  50  ,   100
C 0,0,0


        1111111111111111111111111
        1000000000110000000000001
        1011000001110000000000001
        1001000000000000000000001
111111111011000001110000000000001
100000000011000001110111111111111
11110111111111011100000010001
11010111000111011101010010001
11111111111111111111111111111
1
11111111111111111111111111111111111
11000000110101011100000010001
100N00000000000001100000010001
10000000000000001101010010001
110000011101010111110111100111
11110111 1110101 101111010001
11111111 1111111 111111111111
11111111111111111111111111111111