NO ./textures/1.png
SO ./textures/2.png
WE ./textures/1.png
EA ./textures/3.png
F 255,255,255
C 0,0,0

1111111
100N001
1000101
1000001
1111111

