NO ./textures/cropped.xpm
SO ./textures/cropped.xpm
WE ./textures/cropped.xpm
EA ./textures/cropped.xpm
F 220,100,0
C 225,30,0


        1111111111111111111111111
        1000000000110000000000001
        1011000001110000001000N01
        1001000000000000010000001
111111111011000001110000000000001
100000000011000001110111111111111
11110111111111011100000010001
11110111111111011101010010001
11111111110101011100000010001
10000000000000001100000000001
11111111111111111101010010001
1100000111010101111101111000111
11110111 1110101 101111010001
11111111 1111111 111111111111

